11111111
10000001
10C00001
10000001
100P00E1
11111111